WWWWWWWWWWWWWWW
W M  WW  W W  W
W   WWW  W W  W
W W  WW  W W  W
W W           W
W W  WW  WWWWWW
WWW  WW  WW  WW
W    WW       W
WW   WWW W WWWW
WWW      W    W
W WWW   WWWW WW
W     W    W  W
W WWW W WWWWWWW
W W           G
WWWWWWWWWWWWWWW
